Main:
Er ist klar = se on tyhjä
ich = I -e	Komme
du = you -st	Kommst
-
es = it -t	kommt
er = he -t	kommt
sie = she -t	kommt
-
Sie = they -en	kommen
ihr = your -t	kommt
wir = we -en	kommen
/Numerot
0 null
1 eins
2 zwei
3 drei
4 vier
5 fünf
6 sechs
7 sieben
8 acht
9 neun
10 zehn
11 elf 
12 zwölf 
13 dreizehn
14 vierzehn
15 fünfzehn
16 sechzehn
17 siebzehn
18 achtzehn
19 neunzehn
20 zwanzig
\Numerot
/Sanoja
wohnen = asua
spielen = pelata
lieben = rakastaa
gehen = mennä jonnekin / mennä
singen = laulaa
kommen = tulla
moin=hei
guten morgen = hyvää huomenta
guten tag = hyvää päivää
guten abend = hyvää iltaa
grüezi=hyvää huomenta
tschüss=hei hei
wie geht's dir=mitä sinulle kuuluu
danke gut und dir = kiitos hyvää entä sinulle
wie geht's Ihnen=Mitä teille kuuluu
es geht mir gut=minulle kuuluu hyvää
lustig = funny
traurig = sad 
gesund = healthy
wichtig = Important
Langsam = slow
weit=far
schnell=fast
neu = new
teuer=expensive
schön=pretty
kalt=cold
schwer=heavy
müde=tired
haustier=pet
jung=young
hoch=high
leider=unfortunately
alles klar=all right
geht = walks
will=wants
mache=make
laufen=walk
schreibst=write
mag=like
kennt=knows
Sie trägt=she is wearing 
der schuh=the shoe
die kleidung=the clothing
groß=big
klein=small
gesund=healthy
stark=strong
\Sanoja
/LS
Das ist einfach = that is easy
Der Junge ist lustig = the boy is funny
Sie sprechen nicht = they are not speaking
ich bin fertig = i am ready
Ich bin nicht aus Indien = Im not from india
es ist nicht lustig = it is not funny
Ich bin nicht fertig = i am not ready
es ist kalt=it is cold
David und Max seid ihr müde = David and Max are you tired
Mir geht's gut danke=I am doing well thanks
es tut mir leid=I am sorry
wir schlafen = we are sleeping
er liest=he is reading
ein Fisch und ein hund schwimmen=a fish and a dog are swimming
Ich brauche wasser=i need water
Habt ihr schuhe=do you have shoes
Du isst eis=you are eating
Erdbeeren sind lecker=strawberries taste good
\LS
ei=ai
eu=oi
ie=ii
grüß gott=hyvää huomenta/päivää/iltaa
auf wiedersehen=näkemiin
